Year,SETR Category,Award level,Total Graduates,US Graduates,US Nonresident Graduates
2014,Artificial Intelligence,All award levels (total),41726,32630,9096
2014,Artificial Intelligence,Associate's degree,2519,2462,57
2014,Artificial Intelligence,Bachelor's degree,23539,21913,1626
2014,Artificial Intelligence,Doctor's degree – other,48,47,1
2014,Artificial Intelligence,Doctor's degree – research/scholarship,1151,524,627
2014,Artificial Intelligence,Master's degree,13535,6839,6696
2014,Artificial Intelligence,Post-master's certificate,35,23,12
2014,Artificial Intelligence,Postbaccalaureate certificate,465,393,72
2014,Artificial Intelligence,Postsecondary certificate < 60 semester credit hours,287,283,4
2014,Artificial Intelligence,Postsecondary certificate > 60 semester credit hours,147,146,1
2014,Biotechnology and Synthetic Biology,All award levels (total),20010,17894,2116
2014,Biotechnology and Synthetic Biology,Associate's degree,820,786,34
2014,Biotechnology and Synthetic Biology,Bachelor's degree,14447,13735,712
2014,Biotechnology and Synthetic Biology,Doctor's degree – research/scholarship,1739,1169,570
2014,Biotechnology and Synthetic Biology,Master's degree,2708,1938,770
2014,Biotechnology and Synthetic Biology,Post-master's certificate,48,39,9
2014,Biotechnology and Synthetic Biology,Postbaccalaureate certificate,93,78,15
2014,Biotechnology and Synthetic Biology,Postsecondary certificate < 60 semester credit hours,155,149,6
2014,Cryptography,All award levels (total),73860,61510,12350
2014,Cryptography,Associate's degree,5770,5594,176
2014,Cryptography,Bachelor's degree,46900,43108,3792
2014,Cryptography,Doctor's degree – other,48,47,1
2014,Cryptography,Doctor's degree – research/scholarship,2257,1144,1113
2014,Cryptography,Master's degree,16842,9810,7032
2014,Cryptography,Post-master's certificate,64,45,19
2014,Cryptography,Postbaccalaureate certificate,1111,908,203
2014,Cryptography,Postsecondary certificate < 60 semester credit hours,711,698,13
2014,Cryptography,Postsecondary certificate > 60 semester credit hours,157,156,1
2014,Lasers,All award levels (total),38014,28003,10011
2014,Lasers,Associate's degree,7906,7852,54
2014,Lasers,Bachelor's degree,16195,14363,1832
2014,Lasers,Doctor's degree – other,1,1,0
2014,Lasers,Doctor's degree – research/scholarship,2367,771,1596
2014,Lasers,Master's degree,10309,3851,6458
2014,Lasers,Post-master's certificate,56,28,28
2014,Lasers,Postbaccalaureate certificate,93,56,37
2014,Lasers,Postsecondary certificate < 60 semester credit hours,1058,1052,6
2014,Lasers,Postsecondary certificate > 60 semester credit hours,29,29,0
2014,Materials Science,All award levels (total),16832,13001,3831
2014,Materials Science,Associate's degree,76,74,2
2014,Materials Science,Bachelor's degree,10549,9578,971
2014,Materials Science,Doctor's degree – research/scholarship,1960,939,1021
2014,Materials Science,Master's degree,3982,2172,1810
2014,Materials Science,Post-master's certificate,30,15,15
2014,Materials Science,Postbaccalaureate certificate,181,171,10
2014,Materials Science,Postsecondary certificate < 60 semester credit hours,52,50,2
2014,Materials Science,Postsecondary certificate > 60 semester credit hours,2,2,0
2014,Neuroscience,All award levels (total),8201,7675,526
2014,Neuroscience,Bachelor's degree,6509,6340,169
2014,Neuroscience,Doctor's degree – research/scholarship,1138,909,229
2014,Neuroscience,Master's degree,500,383,117
2014,Neuroscience,Post-master's certificate,33,26,7
2014,Neuroscience,Postbaccalaureate certificate,16,12,4
2014,Neuroscience,Postsecondary certificate < 60 semester credit hours,5,5,0
2014,Robotics,All award levels (total),58812,44180,14632
2014,Robotics,Associate's degree,5914,5810,104
2014,Robotics,Bachelor's degree,28053,25623,2430
2014,Robotics,Doctor's degree – other,5,5,0
2014,Robotics,Doctor's degree – research/scholarship,2859,963,1896
2014,Robotics,Master's degree,18858,8793,10065
2014,Robotics,Post-master's certificate,71,36,35
2014,Robotics,Postbaccalaureate certificate,959,869,90
2014,Robotics,Postsecondary certificate < 60 semester credit hours,2045,2033,12
2014,Robotics,Postsecondary certificate > 60 semester credit hours,48,48,0
2014,Semiconductors,All award levels (total),49910,37506,12404
2014,Semiconductors,Associate's degree,7458,7402,56
2014,Semiconductors,Bachelor's degree,25080,22439,2641
2014,Semiconductors,Doctor's degree – other,1,1,0
2014,Semiconductors,Doctor's degree – research/scholarship,3463,1293,2170
2014,Semiconductors,Master's degree,12605,5172,7433
2014,Semiconductors,Post-master's certificate,70,32,38
2014,Semiconductors,Postbaccalaureate certificate,287,229,58
2014,Semiconductors,Postsecondary certificate < 60 semester credit hours,935,927,8
2014,Semiconductors,Postsecondary certificate > 60 semester credit hours,11,11,0
2014,Space,All award levels (total),14690,13082,1608
2014,Space,Associate's degree,101,100,1
2014,Space,Bachelor's degree,10069,9554,515
2014,Space,Doctor's degree – research/scholarship,1040,686,354
2014,Space,Master's degree,3372,2662,710
2014,Space,Post-master's certificate,31,17,14
2014,Space,Postbaccalaureate certificate,62,48,14
2014,Space,Postsecondary certificate < 60 semester credit hours,15,15,0
2014,Sustainable Energy Technology,All award levels (total),15851,14814,1037
2014,Sustainable Energy Technology,Associate's degree,1830,1815,15
2014,Sustainable Energy Technology,Bachelor's degree,9577,9327,250
2014,Sustainable Energy Technology,Doctor's degree – research/scholarship,474,300,174
2014,Sustainable Energy Technology,Master's degree,3411,2833,578
2014,Sustainable Energy Technology,Post-master's certificate,18,12,6
2014,Sustainable Energy Technology,Postbaccalaureate certificate,105,94,11
2014,Sustainable Energy Technology,Postsecondary certificate < 60 semester credit hours,436,433,3
2015,Artificial Intelligence,All award levels (total),49218,35834,13384
2015,Artificial Intelligence,Associate's degree,2865,2783,82
2015,Artificial Intelligence,Bachelor's degree,26227,24308,1919
2015,Artificial Intelligence,Doctor's degree – other,48,48,0
2015,Artificial Intelligence,Doctor's degree – research/scholarship,1175,531,644
2015,Artificial Intelligence,Master's degree,17823,7251,10572
2015,Artificial Intelligence,Post-master's certificate,43,20,23
2015,Artificial Intelligence,Postbaccalaureate certificate,575,442,133
2015,Artificial Intelligence,Postsecondary certificate < 60 semester credit hours,321,314,7
2015,Artificial Intelligence,Postsecondary certificate > 60 semester credit hours,141,137,4
2015,Biotechnology and Synthetic Biology,All award levels (total),20842,18726,2116
2015,Biotechnology and Synthetic Biology,Associate's degree,715,691,24
2015,Biotechnology and Synthetic Biology,Bachelor's degree,15496,14731,765
2015,Biotechnology and Synthetic Biology,Doctor's degree – research/scholarship,1621,1102,519
2015,Biotechnology and Synthetic Biology,Master's degree,2691,1903,788
2015,Biotechnology and Synthetic Biology,Post-master's certificate,58,51,7
2015,Biotechnology and Synthetic Biology,Postbaccalaureate certificate,90,81,9
2015,Biotechnology and Synthetic Biology,Postsecondary certificate < 60 semester credit hours,163,159,4
2015,Biotechnology and Synthetic Biology,Postsecondary certificate > 60 semester credit hours,8,8,0
2015,Cryptography,All award levels (total),82456,65819,16637
2015,Cryptography,Associate's degree,6822,6625,197
2015,Cryptography,Bachelor's degree,49968,45679,4289
2015,Cryptography,Doctor's degree – other,48,48,0
2015,Cryptography,Doctor's degree – research/scholarship,2266,1138,1128
2015,Cryptography,Master's degree,21202,10474,10728
2015,Cryptography,Post-master's certificate,133,67,66
2015,Cryptography,Postbaccalaureate certificate,1011,800,211
2015,Cryptography,Postsecondary certificate < 60 semester credit hours,860,846,14
2015,Cryptography,Postsecondary certificate > 60 semester credit hours,146,142,4
2015,Lasers,All award levels (total),40727,28094,12633
2015,Lasers,Associate's degree,7839,7795,44
2015,Lasers,Bachelor's degree,16833,14644,2189
2015,Lasers,Doctor's degree – other,3,2,1
2015,Lasers,Doctor's degree – research/scholarship,2408,792,1616
2015,Lasers,Master's degree,12304,3625,8679
2015,Lasers,Post-master's certificate,73,40,33
2015,Lasers,Postbaccalaureate certificate,120,60,60
2015,Lasers,Postsecondary certificate < 60 semester credit hours,1106,1095,11
2015,Lasers,Postsecondary certificate > 60 semester credit hours,41,41,0
2015,Materials Science,All award levels (total),18379,14195,4184
2015,Materials Science,Associate's degree,97,84,13
2015,Materials Science,Bachelor's degree,11702,10607,1095
2015,Materials Science,Doctor's degree – research/scholarship,2098,1027,1071
2015,Materials Science,Master's degree,4193,2219,1974
2015,Materials Science,Post-master's certificate,23,10,13
2015,Materials Science,Postbaccalaureate certificate,234,217,17
2015,Materials Science,Postsecondary certificate < 60 semester credit hours,32,31,1
2015,Neuroscience,All award levels (total),9049,8491,558
2015,Neuroscience,Bachelor's degree,7309,7122,187
2015,Neuroscience,Doctor's degree – professional practice,2,2,0
2015,Neuroscience,Doctor's degree – research/scholarship,1116,895,221
2015,Neuroscience,Master's degree,566,424,142
2015,Neuroscience,Post-master's certificate,32,27,5
2015,Neuroscience,Postbaccalaureate certificate,11,8,3
2015,Neuroscience,Postsecondary certificate < 60 semester credit hours,13,13,0
2015,Robotics,All award levels (total),63770,45194,18576
2015,Robotics,Associate's degree,6180,6074,106
2015,Robotics,Bachelor's degree,30114,27196,2918
2015,Robotics,Doctor's degree – other,3,2,1
2015,Robotics,Doctor's degree – research/scholarship,2808,966,1842
2015,Robotics,Master's degree,21858,8331,13527
2015,Robotics,Post-master's certificate,71,36,35
2015,Robotics,Postbaccalaureate certificate,847,708,139
2015,Robotics,Postsecondary certificate < 60 semester credit hours,1844,1836,8
2015,Robotics,Postsecondary certificate > 60 semester credit hours,45,45,0
2015,Semiconductors,All award levels (total),53819,38591,15228
2015,Semiconductors,Associate's degree,7347,7295,52
2015,Semiconductors,Bachelor's degree,26707,23602,3105
2015,Semiconductors,Doctor's degree – other,3,2,1
2015,Semiconductors,Doctor's degree – research/scholarship,3516,1360,2156
2015,Semiconductors,Master's degree,14866,5088,9778
2015,Semiconductors,Post-master's certificate,72,29,43
2015,Semiconductors,Postbaccalaureate certificate,346,263,83
2015,Semiconductors,Postsecondary certificate < 60 semester credit hours,953,943,10
2015,Semiconductors,Postsecondary certificate > 60 semester credit hours,9,9,0
2015,Space,All award levels (total),15244,13666,1578
2015,Space,Associate's degree,112,110,2
2015,Space,Bachelor's degree,10683,10175,508
2015,Space,Doctor's degree – research/scholarship,981,658,323
2015,Space,Master's degree,3345,2638,707
2015,Space,Post-master's certificate,35,19,16
2015,Space,Postbaccalaureate certificate,77,55,22
2015,Space,Postsecondary certificate < 60 semester credit hours,11,11,0
2015,Sustainable Energy Technology,All award levels (total),15903,14721,1182
2015,Sustainable Energy Technology,Associate's degree,1771,1683,88
2015,Sustainable Energy Technology,Bachelor's degree,9803,9524,279
2015,Sustainable Energy Technology,Doctor's degree – professional practice,2,1,1
2015,Sustainable Energy Technology,Doctor's degree – research/scholarship,522,360,162
2015,Sustainable Energy Technology,Master's degree,3306,2673,633
2015,Sustainable Energy Technology,Post-master's certificate,50,36,14
2015,Sustainable Energy Technology,Postbaccalaureate certificate,95,90,5
2015,Sustainable Energy Technology,Postsecondary certificate < 60 semester credit hours,354,354,0
2016,Artificial Intelligence,All award levels (total),58437,39914,18523
2016,Artificial Intelligence,Associate's degree,2990,2875,115
2016,Artificial Intelligence,Bachelor's degree,30269,27829,2440
2016,Artificial Intelligence,Doctor's degree – other,43,43,0
2016,Artificial Intelligence,Doctor's degree – research/scholarship,1165,499,666
2016,Artificial Intelligence,Master's degree,22764,7709,15055
2016,Artificial Intelligence,Post-master's certificate,34,18,16
2016,Artificial Intelligence,Postbaccalaureate certificate,705,485,220
2016,Artificial Intelligence,Postsecondary certificate < 60 semester credit hours,321,315,6
2016,Artificial Intelligence,Postsecondary certificate > 60 semester credit hours,146,141,5
2016,Biotechnology and Synthetic Biology,All award levels (total),22104,19834,2270
2016,Biotechnology and Synthetic Biology,Associate's degree,777,753,24
2016,Biotechnology and Synthetic Biology,Bachelor's degree,16509,15715,794
2016,Biotechnology and Synthetic Biology,Doctor's degree – research/scholarship,1621,1087,534
2016,Biotechnology and Synthetic Biology,Master's degree,2942,2047,895
2016,Biotechnology and Synthetic Biology,Post-master's certificate,40,31,9
2016,Biotechnology and Synthetic Biology,Postbaccalaureate certificate,89,77,12
2016,Biotechnology and Synthetic Biology,Postsecondary certificate < 60 semester credit hours,123,121,2
2016,Biotechnology and Synthetic Biology,Postsecondary certificate > 60 semester credit hours,3,3,0
2016,Cryptography,All award levels (total),90931,69009,21922
2016,Cryptography,Associate's degree,7435,7149,286
2016,Cryptography,Bachelor's degree,52827,47618,5209
2016,Cryptography,Doctor's degree – other,43,43,0
2016,Cryptography,Doctor's degree – research/scholarship,2312,1157,1155
2016,Cryptography,Master's degree,25814,11008,14806
2016,Cryptography,Post-master's certificate,109,63,46
2016,Cryptography,Postbaccalaureate certificate,1436,1035,401
2016,Cryptography,Postsecondary certificate < 60 semester credit hours,797,783,14
2016,Cryptography,Postsecondary certificate > 60 semester credit hours,158,153,5
2016,Lasers,All award levels (total),40136,25396,14740
2016,Lasers,Associate's degree,4507,4448,59
2016,Lasers,Bachelor's degree,17824,15476,2348
2016,Lasers,Doctor's degree – other,1,0,1
2016,Lasers,Doctor's degree – research/scholarship,2343,757,1586
2016,Lasers,Master's degree,14145,3537,10608
2016,Lasers,Post-master's certificate,43,11,32
2016,Lasers,Postbaccalaureate certificate,154,57,97
2016,Lasers,Postsecondary certificate < 60 semester credit hours,1097,1088,9
2016,Lasers,Postsecondary certificate > 60 semester credit hours,22,22,0
2016,Materials Science,All award levels (total),19696,15182,4514
2016,Materials Science,Associate's degree,76,71,5
2016,Materials Science,Bachelor's degree,12872,11582,1290
2016,Materials Science,Doctor's degree – research/scholarship,2148,1067,1081
2016,Materials Science,Master's degree,4289,2188,2101
2016,Materials Science,Post-master's certificate,31,17,14
2016,Materials Science,Postbaccalaureate certificate,255,234,21
2016,Materials Science,Postsecondary certificate < 60 semester credit hours,25,23,2
2016,Neuroscience,All award levels (total),9834,9202,632
2016,Neuroscience,Bachelor's degree,7967,7712,255
2016,Neuroscience,Doctor's degree – research/scholarship,1117,892,225
2016,Neuroscience,Master's degree,655,514,141
2016,Neuroscience,Post-master's certificate,54,46,8
2016,Neuroscience,Postbaccalaureate certificate,20,17,3
2016,Neuroscience,Postsecondary certificate < 60 semester credit hours,21,21,0
2016,Robotics,All award levels (total),70542,47596,22946
2016,Robotics,Associate's degree,6333,6206,127
2016,Robotics,Bachelor's degree,32994,29719,3275
2016,Robotics,Doctor's degree – other,1,0,1
2016,Robotics,Doctor's degree – research/scholarship,2840,951,1889
2016,Robotics,Master's degree,25699,8308,17391
2016,Robotics,Post-master's certificate,59,24,35
2016,Robotics,Postbaccalaureate certificate,953,733,220
2016,Robotics,Postsecondary certificate < 60 semester credit hours,1621,1613,8
2016,Robotics,Postsecondary certificate > 60 semester credit hours,42,42,0
2016,Semiconductors,All award levels (total),54063,36555,17508
2016,Semiconductors,Associate's degree,3990,3928,62
2016,Semiconductors,Bachelor's degree,28659,25262,3397
2016,Semiconductors,Doctor's degree – other,1,0,1
2016,Semiconductors,Doctor's degree – research/scholarship,3472,1331,2141
2016,Semiconductors,Master's degree,16574,4846,11728
2016,Semiconductors,Post-master's certificate,69,26,43
2016,Semiconductors,Postbaccalaureate certificate,410,285,125
2016,Semiconductors,Postsecondary certificate < 60 semester credit hours,888,877,11
2016,Space,All award levels (total),15744,14027,1717
2016,Space,Associate's degree,120,119,1
2016,Space,Bachelor's degree,10993,10447,546
2016,Space,Doctor's degree – research/scholarship,1091,718,373
2016,Space,Master's degree,3428,2652,776
2016,Space,Post-master's certificate,43,32,11
2016,Space,Postbaccalaureate certificate,60,52,8
2016,Space,Postsecondary certificate < 60 semester credit hours,9,7,2
2016,Sustainable Energy Technology,All award levels (total),16008,14792,1216
2016,Sustainable Energy Technology,Associate's degree,1553,1528,25
2016,Sustainable Energy Technology,Bachelor's degree,10147,9852,295
2016,Sustainable Energy Technology,Doctor's degree – research/scholarship,500,341,159
2016,Sustainable Energy Technology,Master's degree,3370,2660,710
2016,Sustainable Energy Technology,Post-master's certificate,11,6,5
2016,Sustainable Energy Technology,Postbaccalaureate certificate,131,110,21
2016,Sustainable Energy Technology,Postsecondary certificate < 60 semester credit hours,275,274,1
2016,Sustainable Energy Technology,Postsecondary certificate > 60 semester credit hours,21,21,0
2017,Artificial Intelligence,All award levels (total),66615,44995,21620
2017,Artificial Intelligence,Associate's degree,3396,3272,124
2017,Artificial Intelligence,Bachelor's degree,34679,31582,3097
2017,Artificial Intelligence,Doctor's degree – other,50,50,0
2017,Artificial Intelligence,Doctor's degree – research/scholarship,1203,541,662
2017,Artificial Intelligence,Master's degree,25644,8384,17260
2017,Artificial Intelligence,Post-master's certificate,45,28,17
2017,Artificial Intelligence,Postbaccalaureate certificate,1003,558,445
2017,Artificial Intelligence,Postsecondary certificate < 60 semester credit hours,455,442,13
2017,Artificial Intelligence,Postsecondary certificate > 60 semester credit hours,140,138,2
2017,Biotechnology and Synthetic Biology,All award levels (total),22572,20264,2308
2017,Biotechnology and Synthetic Biology,Associate's degree,664,646,18
2017,Biotechnology and Synthetic Biology,Bachelor's degree,17029,16106,923
2017,Biotechnology and Synthetic Biology,Doctor's degree – research/scholarship,1601,1097,504
2017,Biotechnology and Synthetic Biology,Master's degree,2987,2149,838
2017,Biotechnology and Synthetic Biology,Post-master's certificate,53,40,13
2017,Biotechnology and Synthetic Biology,Postbaccalaureate certificate,86,77,9
2017,Biotechnology and Synthetic Biology,Postsecondary certificate < 60 semester credit hours,146,143,3
2017,Biotechnology and Synthetic Biology,Postsecondary certificate > 60 semester credit hours,6,6,0
2017,Cryptography,All award levels (total),101358,75463,25895
2017,Cryptography,Associate's degree,8480,8111,369
2017,Cryptography,Bachelor's degree,57907,51676,6231
2017,Cryptography,Doctor's degree – other,50,50,0
2017,Cryptography,Doctor's degree – research/scholarship,2352,1201,1151
2017,Cryptography,Master's degree,29401,11972,17429
2017,Cryptography,Post-master's certificate,130,77,53
2017,Cryptography,Postbaccalaureate certificate,1959,1314,645
2017,Cryptography,Postsecondary certificate < 60 semester credit hours,938,923,15
2017,Cryptography,Postsecondary certificate > 60 semester credit hours,141,139,2
2017,Lasers,All award levels (total),40323,26405,13918
2017,Lasers,Associate's degree,4439,4379,60
2017,Lasers,Bachelor's degree,19032,16554,2478
2017,Lasers,Doctor's degree – other,1,0,1
2017,Lasers,Doctor's degree – research/scholarship,2374,681,1693
2017,Lasers,Master's degree,13075,3491,9584
2017,Lasers,Post-master's certificate,36,29,7
2017,Lasers,Postbaccalaureate certificate,176,92,84
2017,Lasers,Postsecondary certificate < 60 semester credit hours,1176,1165,11
2017,Lasers,Postsecondary certificate > 60 semester credit hours,14,14,0
2017,Materials Science,All award levels (total),21127,16286,4841
2017,Materials Science,Associate's degree,76,62,14
2017,Materials Science,Bachelor's degree,14094,12578,1516
2017,Materials Science,Doctor's degree – research/scholarship,2157,1081,1076
2017,Materials Science,Master's degree,4551,2345,2206
2017,Materials Science,Post-master's certificate,23,12,11
2017,Materials Science,Postbaccalaureate certificate,208,191,17
2017,Materials Science,Postsecondary certificate < 60 semester credit hours,18,17,1
2017,Neuroscience,All award levels (total),10631,9999,632
2017,Neuroscience,Associate's degree,8,8,0
2017,Neuroscience,Bachelor's degree,8763,8477,286
2017,Neuroscience,Doctor's degree – professional practice,3,3,0
2017,Neuroscience,Doctor's degree – research/scholarship,1115,913,202
2017,Neuroscience,Master's degree,656,517,139
2017,Neuroscience,Post-master's certificate,31,31,0
2017,Neuroscience,Postbaccalaureate certificate,28,23,5
2017,Neuroscience,Postsecondary certificate < 60 semester credit hours,27,27,0
2017,Robotics,All award levels (total),73683,50651,23032
2017,Robotics,Associate's degree,6478,6348,130
2017,Robotics,Bachelor's degree,36457,32816,3641
2017,Robotics,Doctor's degree – other,1,0,1
2017,Robotics,Doctor's degree – research/scholarship,2886,895,1991
2017,Robotics,Master's degree,25366,8305,17061
2017,Robotics,Post-master's certificate,40,30,10
2017,Robotics,Postbaccalaureate certificate,988,803,185
2017,Robotics,Postsecondary certificate < 60 semester credit hours,1416,1403,13
2017,Robotics,Postsecondary certificate > 60 semester credit hours,51,51,0
2017,Semiconductors,All award levels (total),55501,38619,16882
2017,Semiconductors,Associate's degree,3849,3778,71
2017,Semiconductors,Bachelor's degree,31021,27305,3716
2017,Semiconductors,Doctor's degree – other,1,0,1
2017,Semiconductors,Doctor's degree – research/scholarship,3519,1272,2247
2017,Semiconductors,Master's degree,15675,4976,10699
2017,Semiconductors,Post-master's certificate,50,32,18
2017,Semiconductors,Postbaccalaureate certificate,408,290,118
2017,Semiconductors,Postsecondary certificate < 60 semester credit hours,977,965,12
2017,Semiconductors,Postsecondary certificate > 60 semester credit hours,1,1,0
2017,Space,All award levels (total),16217,14434,1783
2017,Space,Associate's degree,157,151,6
2017,Space,Bachelor's degree,11320,10743,577
2017,Space,Doctor's degree – research/scholarship,1084,717,367
2017,Space,Master's degree,3546,2737,809
2017,Space,Post-master's certificate,32,23,9
2017,Space,Postbaccalaureate certificate,72,57,15
2017,Space,Postsecondary certificate < 60 semester credit hours,6,6,0
2017,Sustainable Energy Technology,All award levels (total),16435,15186,1249
2017,Sustainable Energy Technology,Associate's degree,1419,1391,28
2017,Sustainable Energy Technology,Bachelor's degree,10548,10227,321
2017,Sustainable Energy Technology,Doctor's degree – research/scholarship,502,348,154
2017,Sustainable Energy Technology,Master's degree,3443,2713,730
2017,Sustainable Energy Technology,Post-master's certificate,11,5,6
2017,Sustainable Energy Technology,Postbaccalaureate certificate,129,120,9
2017,Sustainable Energy Technology,Postsecondary certificate < 60 semester credit hours,383,382,1
2018,Artificial Intelligence,All award levels (total),70367,49438,20929
2018,Artificial Intelligence,Associate's degree,3803,3591,212
2018,Artificial Intelligence,Bachelor's degree,39947,35871,4076
2018,Artificial Intelligence,Doctor's degree – other,45,45,0
2018,Artificial Intelligence,Doctor's degree – research/scholarship,1203,525,678
2018,Artificial Intelligence,Master's degree,23567,8092,15475
2018,Artificial Intelligence,Post-master's certificate,97,47,50
2018,Artificial Intelligence,Postbaccalaureate certificate,1034,614,420
2018,Artificial Intelligence,Postsecondary certificate < 60 semester credit hours,515,500,15
2018,Artificial Intelligence,Postsecondary certificate > 60 semester credit hours,156,153,3
2018,Biotechnology and Synthetic Biology,All award levels (total),23107,20751,2356
2018,Biotechnology and Synthetic Biology,Associate's degree,694,677,17
2018,Biotechnology and Synthetic Biology,Bachelor's degree,17526,16519,1007
2018,Biotechnology and Synthetic Biology,Doctor's degree – research/scholarship,1641,1155,486
2018,Biotechnology and Synthetic Biology,Master's degree,2942,2124,818
2018,Biotechnology and Synthetic Biology,Post-master's certificate,37,31,6
2018,Biotechnology and Synthetic Biology,Postbaccalaureate certificate,103,86,17
2018,Biotechnology and Synthetic Biology,Postsecondary certificate < 60 semester credit hours,162,157,5
2018,Biotechnology and Synthetic Biology,Postsecondary certificate > 60 semester credit hours,2,2,0
2018,Cryptography,All award levels (total),109563,82432,27131
2018,Cryptography,Associate's degree,9896,9386,510
2018,Cryptography,Bachelor's degree,63421,56017,7404
2018,Cryptography,Doctor's degree – other,45,45,0
2018,Cryptography,Doctor's degree – research/scholarship,2401,1195,1206
2018,Cryptography,Master's degree,30120,12866,17254
2018,Cryptography,Post-master's certificate,185,100,85
2018,Cryptography,Postbaccalaureate certificate,2165,1522,643
2018,Cryptography,Postsecondary certificate < 60 semester credit hours,1182,1156,26
2018,Cryptography,Postsecondary certificate > 60 semester credit hours,148,145,3
2018,Lasers,All award levels (total),39211,26463,12748
2018,Lasers,Associate's degree,4585,4518,67
2018,Lasers,Bachelor's degree,18863,16295,2568
2018,Lasers,Doctor's degree – research/scholarship,2396,699,1697
2018,Lasers,Master's degree,11900,3585,8315
2018,Lasers,Post-master's certificate,39,16,23
2018,Lasers,Postbaccalaureate certificate,108,39,69
2018,Lasers,Postsecondary certificate < 60 semester credit hours,1288,1279,9
2018,Lasers,Postsecondary certificate > 60 semester credit hours,32,32,0
2018,Materials Science,All award levels (total),22164,16992,5172
2018,Materials Science,Associate's degree,65,49,16
2018,Materials Science,Bachelor's degree,14683,13035,1648
2018,Materials Science,Doctor's degree – research/scholarship,2190,1071,1119
2018,Materials Science,Master's degree,4903,2549,2354
2018,Materials Science,Post-master's certificate,28,16,12
2018,Materials Science,Postbaccalaureate certificate,246,223,23
2018,Materials Science,Postsecondary certificate < 60 semester credit hours,48,48,0
2018,Materials Science,Postsecondary certificate > 60 semester credit hours,1,1,0
2018,Neuroscience,All award levels (total),11243,10556,687
2018,Neuroscience,Associate's degree,3,3,0
2018,Neuroscience,Bachelor's degree,9301,8974,327
2018,Neuroscience,Doctor's degree – professional practice,3,3,0
2018,Neuroscience,Doctor's degree – research/scholarship,1104,909,195
2018,Neuroscience,Master's degree,741,583,158
2018,Neuroscience,Post-master's certificate,35,34,1
2018,Neuroscience,Postbaccalaureate certificate,37,31,6
2018,Neuroscience,Postsecondary certificate < 60 semester credit hours,19,19,0
2018,Robotics,All award levels (total),74772,53010,21762
2018,Robotics,Associate's degree,7123,6912,211
2018,Robotics,Bachelor's degree,38678,34525,4153
2018,Robotics,Doctor's degree – research/scholarship,2914,899,2015
2018,Robotics,Master's degree,23481,8344,15137
2018,Robotics,Post-master's certificate,90,54,36
2018,Robotics,Postbaccalaureate certificate,952,752,200
2018,Robotics,Postsecondary certificate < 60 semester credit hours,1489,1479,10
2018,Robotics,Postsecondary certificate > 60 semester credit hours,45,45,0
2018,Semiconductors,All award levels (total),54733,38703,16030
2018,Semiconductors,Associate's degree,3468,3390,78
2018,Semiconductors,Bachelor's degree,31465,27476,3989
2018,Semiconductors,Doctor's degree – research/scholarship,3553,1282,2271
2018,Semiconductors,Master's degree,14739,5202,9537
2018,Semiconductors,Post-master's certificate,56,26,30
2018,Semiconductors,Postbaccalaureate certificate,377,261,116
2018,Semiconductors,Postsecondary certificate < 60 semester credit hours,1071,1062,9
2018,Semiconductors,Postsecondary certificate > 60 semester credit hours,4,4,0
2018,Space,All award levels (total),16420,14570,1850
2018,Space,Associate's degree,137,136,1
2018,Space,Bachelor's degree,11581,10927,654
2018,Space,Doctor's degree – other,1,0,1
2018,Space,Doctor's degree – research/scholarship,1109,722,387
2018,Space,Master's degree,3442,2656,786
2018,Space,Post-master's certificate,51,41,10
2018,Space,Postbaccalaureate certificate,89,78,11
2018,Space,Postsecondary certificate < 60 semester credit hours,10,10,0
2018,Sustainable Energy Technology,All award levels (total),16913,15571,1342
2018,Sustainable Energy Technology,Associate's degree,1392,1381,11
2018,Sustainable Energy Technology,Bachelor's degree,11101,10707,394
2018,Sustainable Energy Technology,Doctor's degree – research/scholarship,477,322,155
2018,Sustainable Energy Technology,Master's degree,3415,2656,759
2018,Sustainable Energy Technology,Post-master's certificate,7,0,7
2018,Sustainable Energy Technology,Postbaccalaureate certificate,158,142,16
2018,Sustainable Energy Technology,Postsecondary certificate < 60 semester credit hours,359,359,0
2018,Sustainable Energy Technology,Postsecondary certificate > 60 semester credit hours,4,4,0
2019,Artificial Intelligence,All award levels (total),75242,55235,20007
2019,Artificial Intelligence,Associate's degree,4184,3881,303
2019,Artificial Intelligence,Bachelor's degree,45011,40237,4774
2019,Artificial Intelligence,Doctor's degree – professional practice,53,53,0
2019,Artificial Intelligence,Doctor's degree – research/scholarship,1378,574,804
2019,Artificial Intelligence,Master's degree,22910,9120,13790
2019,Artificial Intelligence,Post-master's certificate,80,48,32
2019,Artificial Intelligence,Postbaccalaureate certificate,978,685,293
2019,Artificial Intelligence,Postsecondary certificate < 60 semester credit hours,466,459,7
2019,Artificial Intelligence,Postsecondary certificate > 60 semester credit hours,182,178,4
2019,Biotechnology and Synthetic Biology,All award levels (total),23566,21183,2383
2019,Biotechnology and Synthetic Biology,Associate's degree,567,537,30
2019,Biotechnology and Synthetic Biology,Bachelor's degree,17987,16961,1026
2019,Biotechnology and Synthetic Biology,Doctor's degree – research/scholarship,1619,1150,469
2019,Biotechnology and Synthetic Biology,Master's degree,3129,2313,816
2019,Biotechnology and Synthetic Biology,Post-master's certificate,3,1,2
2019,Biotechnology and Synthetic Biology,Postbaccalaureate certificate,133,98,35
2019,Biotechnology and Synthetic Biology,Postsecondary certificate < 60 semester credit hours,128,123,5
2019,Cryptography,All award levels (total),117273,90513,26760
2019,Cryptography,Associate's degree,11116,10448,668
2019,Cryptography,Bachelor's degree,69629,61215,8414
2019,Cryptography,Doctor's degree – professional practice,53,53,0
2019,Cryptography,Doctor's degree – research/scholarship,2601,1284,1317
2019,Cryptography,Master's degree,30033,14276,15757
2019,Cryptography,Post-master's certificate,172,101,71
2019,Cryptography,Postbaccalaureate certificate,2199,1700,499
2019,Cryptography,Postsecondary certificate < 60 semester credit hours,1302,1272,30
2019,Cryptography,Postsecondary certificate > 60 semester credit hours,168,164,4
2019,Lasers,All award levels (total),38619,27115,11504
2019,Lasers,Associate's degree,4734,4645,89
2019,Lasers,Bachelor's degree,19405,16744,2661
2019,Lasers,Doctor's degree – research/scholarship,2358,692,1666
2019,Lasers,Master's degree,10688,3668,7020
2019,Lasers,Post-master's certificate,8,4,4
2019,Lasers,Postbaccalaureate certificate,108,52,56
2019,Lasers,Postsecondary certificate < 60 semester credit hours,1268,1260,8
2019,Lasers,Postsecondary certificate > 60 semester credit hours,50,50,0
2019,Materials Science,All award levels (total),22064,16965,5099
2019,Materials Science,Associate's degree,69,54,15
2019,Materials Science,Bachelor's degree,14514,12912,1602
2019,Materials Science,Doctor's degree – other,2,2,0
2019,Materials Science,Doctor's degree – research/scholarship,2296,1148,1148
2019,Materials Science,Master's degree,4776,2473,2303
2019,Materials Science,Post-master's certificate,56,45,11
2019,Materials Science,Postbaccalaureate certificate,279,260,19
2019,Materials Science,Postsecondary certificate < 60 semester credit hours,72,71,1
2019,Neuroscience,All award levels (total),12134,11197,937
2019,Neuroscience,Associate's degree,1,1,0
2019,Neuroscience,Bachelor's degree,9908,9499,409
2019,Neuroscience,Doctor's degree – professional practice,3,2,1
2019,Neuroscience,Doctor's degree – research/scholarship,1160,939,221
2019,Neuroscience,Master's degree,778,613,165
2019,Neuroscience,Post-master's certificate,196,68,128
2019,Neuroscience,Postbaccalaureate certificate,59,46,13
2019,Neuroscience,Postsecondary certificate < 60 semester credit hours,29,29,0
2019,Robotics,All award levels (total),76139,56022,20117
2019,Robotics,Associate's degree,6943,6768,175
2019,Robotics,Bachelor's degree,41396,37044,4352
2019,Robotics,Doctor's degree – research/scholarship,2891,888,2003
2019,Robotics,Master's degree,22239,8877,13362
2019,Robotics,Post-master's certificate,54,38,16
2019,Robotics,Postbaccalaureate certificate,961,771,190
2019,Robotics,Postsecondary certificate < 60 semester credit hours,1621,1602,19
2019,Robotics,Postsecondary certificate > 60 semester credit hours,34,34,0
2019,Semiconductors,All award levels (total),53974,39187,14787
2019,Semiconductors,Associate's degree,3482,3386,96
2019,Semiconductors,Bachelor's degree,31833,27806,4027
2019,Semiconductors,Doctor's degree – other,2,2,0
2019,Semiconductors,Doctor's degree – research/scholarship,3624,1332,2292
2019,Semiconductors,Master's degree,13484,5210,8274
2019,Semiconductors,Post-master's certificate,59,48,11
2019,Semiconductors,Postbaccalaureate certificate,376,298,78
2019,Semiconductors,Postsecondary certificate < 60 semester credit hours,1111,1102,9
2019,Semiconductors,Postsecondary certificate > 60 semester credit hours,3,3,0
2019,Space,All award levels (total),16966,15103,1863
2019,Space,Associate's degree,164,164,0
2019,Space,Bachelor's degree,11871,11186,685
2019,Space,Doctor's degree – research/scholarship,1172,726,446
2019,Space,Master's degree,3600,2885,715
2019,Space,Post-master's certificate,16,16,0
2019,Space,Postbaccalaureate certificate,134,119,15
2019,Space,Postsecondary certificate < 60 semester credit hours,9,7,2
2019,Sustainable Energy Technology,All award levels (total),17520,16198,1322
2019,Sustainable Energy Technology,Associate's degree,1316,1303,13
2019,Sustainable Energy Technology,Bachelor's degree,11638,11240,398
2019,Sustainable Energy Technology,Doctor's degree – research/scholarship,536,341,195
2019,Sustainable Energy Technology,Master's degree,3568,2864,704
2019,Sustainable Energy Technology,Post-master's certificate,6,6,0
2019,Sustainable Energy Technology,Postbaccalaureate certificate,180,170,10
2019,Sustainable Energy Technology,Postsecondary certificate < 60 semester credit hours,276,274,2
2020,Artificial Intelligence,All award levels (total),83088,60733,22355
2020,Artificial Intelligence,Associate's degree,4719,4357,362
2020,Artificial Intelligence,Bachelor's degree,50186,44342,5844
2020,Artificial Intelligence,Doctor's degree – professional practice,47,47,0
2020,Artificial Intelligence,Doctor's degree – research/scholarship,1449,555,894
2020,Artificial Intelligence,Master's degree,25002,10101,14901
2020,Artificial Intelligence,Post-master's certificate,100,45,55
2020,Artificial Intelligence,Postbaccalaureate certificate,990,696,294
2020,Artificial Intelligence,Postsecondary certificate < 60 semester credit hours,438,435,3
2020,Artificial Intelligence,Postsecondary certificate > 60 semester credit hours,157,155,2
2020,Biotechnology and Synthetic Biology,All award levels (total),24255,21695,2560
2020,Biotechnology and Synthetic Biology,Associate's degree,539,514,25
2020,Biotechnology and Synthetic Biology,Bachelor's degree,18554,17448,1106
2020,Biotechnology and Synthetic Biology,Doctor's degree – research/scholarship,1551,1080,471
2020,Biotechnology and Synthetic Biology,Master's degree,3223,2314,909
2020,Biotechnology and Synthetic Biology,Post-master's certificate,73,60,13
2020,Biotechnology and Synthetic Biology,Postbaccalaureate certificate,178,146,32
2020,Biotechnology and Synthetic Biology,Postsecondary certificate < 60 semester credit hours,137,133,4
2020,Cryptography,All award levels (total),127241,97760,29481
2020,Cryptography,Associate's degree,12350,11579,771
2020,Cryptography,Bachelor's degree,75672,65740,9932
2020,Cryptography,Doctor's degree – professional practice,47,47,0
2020,Cryptography,Doctor's degree – research/scholarship,2619,1210,1409
2020,Cryptography,Master's degree,32297,15469,16828
2020,Cryptography,Post-master's certificate,232,112,120
2020,Cryptography,Postbaccalaureate certificate,2315,1927,388
2020,Cryptography,Postsecondary certificate < 60 semester credit hours,1592,1561,31
2020,Cryptography,Postsecondary certificate > 60 semester credit hours,117,115,2
2020,Lasers,All award levels (total),36725,25903,10822
2020,Lasers,Associate's degree,3708,3633,75
2020,Lasers,Bachelor's degree,19363,16657,2706
2020,Lasers,Doctor's degree – research/scholarship,2434,681,1753
2020,Lasers,Master's degree,9810,3604,6206
2020,Lasers,Post-master's certificate,32,15,17
2020,Lasers,Postbaccalaureate certificate,108,52,56
2020,Lasers,Postsecondary certificate < 60 semester credit hours,1217,1208,9
2020,Lasers,Postsecondary certificate > 60 semester credit hours,53,53,0
2020,Materials Science,All award levels (total),21090,16254,4836
2020,Materials Science,Associate's degree,62,56,6
2020,Materials Science,Bachelor's degree,14006,12476,1530
2020,Materials Science,Doctor's degree – other,1,1,0
2020,Materials Science,Doctor's degree – research/scholarship,2118,1008,1110
2020,Materials Science,Master's degree,4594,2450,2144
2020,Materials Science,Post-master's certificate,22,11,11
2020,Materials Science,Postbaccalaureate certificate,254,221,33
2020,Materials Science,Postsecondary certificate < 60 semester credit hours,33,31,2
2020,Neuroscience,All award levels (total),13266,12259,1007
2020,Neuroscience,Associate's degree,4,4,0
2020,Neuroscience,Bachelor's degree,11025,10571,454
2020,Neuroscience,Doctor's degree – professional practice,4,4,0
2020,Neuroscience,Doctor's degree – research/scholarship,1094,871,223
2020,Neuroscience,Master's degree,845,668,177
2020,Neuroscience,Post-master's certificate,231,79,152
2020,Neuroscience,Postbaccalaureate certificate,34,33,1
2020,Neuroscience,Postsecondary certificate < 60 semester credit hours,29,29,0
2020,Robotics,All award levels (total),77762,57785,19977
2020,Robotics,Associate's degree,7029,6860,169
2020,Robotics,Bachelor's degree,43127,38339,4788
2020,Robotics,Doctor's degree – research/scholarship,3022,898,2124
2020,Robotics,Master's degree,21938,9254,12684
2020,Robotics,Post-master's certificate,67,37,30
2020,Robotics,Postbaccalaureate certificate,1003,838,165
2020,Robotics,Postsecondary certificate < 60 semester credit hours,1528,1512,16
2020,Robotics,Postsecondary certificate > 60 semester credit hours,48,47,1
2020,Semiconductors,All award levels (total),51647,37743,13904
2020,Semiconductors,Associate's degree,3073,2992,81
2020,Semiconductors,Bachelor's degree,31164,27176,3988
2020,Semiconductors,Doctor's degree – other,1,1,0
2020,Semiconductors,Doctor's degree – research/scholarship,3620,1267,2353
2020,Semiconductors,Master's degree,12495,5135,7360
2020,Semiconductors,Post-master's certificate,47,22,25
2020,Semiconductors,Postbaccalaureate certificate,346,259,87
2020,Semiconductors,Postsecondary certificate < 60 semester credit hours,895,885,10
2020,Semiconductors,Postsecondary certificate > 60 semester credit hours,6,6,0
2020,Space,All award levels (total),16959,15135,1824
2020,Space,Associate's degree,170,169,1
2020,Space,Bachelor's degree,11958,11231,727
2020,Space,Doctor's degree – research/scholarship,1177,745,432
2020,Space,Master's degree,3470,2831,639
2020,Space,Post-master's certificate,31,25,6
2020,Space,Postbaccalaureate certificate,141,123,18
2020,Space,Postsecondary certificate < 60 semester credit hours,12,11,1
2020,Sustainable Energy Technology,All award levels (total),16973,15814,1159
2020,Sustainable Energy Technology,Associate's degree,821,812,9
2020,Sustainable Energy Technology,Bachelor's degree,12044,11643,401
2020,Sustainable Energy Technology,Doctor's degree – research/scholarship,485,321,164
2020,Sustainable Energy Technology,Master's degree,3246,2689,557
2020,Sustainable Energy Technology,Post-master's certificate,11,5,6
2020,Sustainable Energy Technology,Postbaccalaureate certificate,196,174,22
2020,Sustainable Energy Technology,Postsecondary certificate < 60 semester credit hours,170,170,0
2021,Artificial Intelligence,All award levels (total),90529,66038,24491
2021,Artificial Intelligence,Associate's degree,5458,5092,366
2021,Artificial Intelligence,Bachelor's degree,54131,47621,6510
2021,Artificial Intelligence,Doctor's degree – professional practice,70,70,0
2021,Artificial Intelligence,Doctor's degree – research/scholarship,1457,551,906
2021,Artificial Intelligence,Master's degree,27428,11208,16220
2021,Artificial Intelligence,Post-master's certificate,92,42,50
2021,Artificial Intelligence,Postbaccalaureate certificate,1268,839,429
2021,Artificial Intelligence,Postsecondary certificate < 60 semester credit hours,456,448,8
2021,Artificial Intelligence,Postsecondary certificate > 60 semester credit hours,169,167,2
2021,Biotechnology and Synthetic Biology,All award levels (total),24646,22221,2425
2021,Biotechnology and Synthetic Biology,Associate's degree,552,526,26
2021,Biotechnology and Synthetic Biology,Bachelor's degree,19001,17981,1020
2021,Biotechnology and Synthetic Biology,Doctor's degree – research/scholarship,1482,1026,456
2021,Biotechnology and Synthetic Biology,Master's degree,3269,2378,891
2021,Biotechnology and Synthetic Biology,Post-master's certificate,35,28,7
2021,Biotechnology and Synthetic Biology,Postbaccalaureate certificate,163,141,22
2021,Biotechnology and Synthetic Biology,Postsecondary certificate < 60 semester credit hours,144,141,3
2021,Cryptography,All award levels (total),136251,105233,31018
2021,Cryptography,Associate's degree,13872,13136,736
2021,Cryptography,Bachelor's degree,79490,69057,10433
2021,Cryptography,Doctor's degree – professional practice,70,70,0
2021,Cryptography,Doctor's degree – research/scholarship,2684,1233,1451
2021,Cryptography,Master's degree,35182,17426,17756
2021,Cryptography,Post-master's certificate,208,123,85
2021,Cryptography,Postbaccalaureate certificate,2722,2196,526
2021,Cryptography,Postsecondary certificate < 60 semester credit hours,1881,1852,29
2021,Cryptography,Postsecondary certificate > 60 semester credit hours,142,140,2
2021,Lasers,All award levels (total),34439,24988,9451
2021,Lasers,Associate's degree,3670,3580,90
2021,Lasers,Bachelor's degree,18662,16246,2416
2021,Lasers,Doctor's degree – research/scholarship,2225,608,1617
2021,Lasers,Master's degree,8704,3440,5264
2021,Lasers,Post-master's certificate,29,9,20
2021,Lasers,Postbaccalaureate certificate,134,102,32
2021,Lasers,Postsecondary certificate < 60 semester credit hours,955,943,12
2021,Lasers,Postsecondary certificate > 60 semester credit hours,60,60,0
2021,Materials Science,All award levels (total),20152,15403,4749
2021,Materials Science,Associate's degree,66,54,12
2021,Materials Science,Bachelor's degree,13032,11741,1291
2021,Materials Science,Doctor's degree – other,2,2,0
2021,Materials Science,Doctor's degree – research/scholarship,2223,1036,1187
2021,Materials Science,Master's degree,4505,2292,2213
2021,Materials Science,Post-master's certificate,25,15,10
2021,Materials Science,Postbaccalaureate certificate,262,227,35
2021,Materials Science,Postsecondary certificate < 60 semester credit hours,37,36,1
2021,Neuroscience,All award levels (total),14042,13167,875
2021,Neuroscience,Associate's degree,1,1,0
2021,Neuroscience,Bachelor's degree,11971,11472,499
2021,Neuroscience,Doctor's degree – professional practice,2,2,0
2021,Neuroscience,Doctor's degree – research/scholarship,1006,831,175
2021,Neuroscience,Master's degree,925,735,190
2021,Neuroscience,Post-master's certificate,45,41,4
2021,Neuroscience,Postbaccalaureate certificate,63,57,6
2021,Neuroscience,Postsecondary certificate < 60 semester credit hours,29,28,1
2021,Robotics,All award levels (total),80154,60930,19224
2021,Robotics,Associate's degree,7450,7272,178
2021,Robotics,Bachelor's degree,44282,39590,4692
2021,Robotics,Doctor's degree – research/scholarship,2817,828,1989
2021,Robotics,Master's degree,22174,10082,12092
2021,Robotics,Post-master's certificate,94,59,35
2021,Robotics,Postbaccalaureate certificate,1485,1269,216
2021,Robotics,Postsecondary certificate < 60 semester credit hours,1806,1785,21
2021,Robotics,Postsecondary certificate > 60 semester credit hours,46,45,1
2021,Semiconductors,All award levels (total),48651,36096,12555
2021,Semiconductors,Associate's degree,3068,2967,101
2021,Semiconductors,Bachelor's degree,29625,26126,3499
2021,Semiconductors,Doctor's degree – other,2,2,0
2021,Semiconductors,Doctor's degree – professional practice,1,1,0
2021,Semiconductors,Doctor's degree – research/scholarship,3451,1167,2284
2021,Semiconductors,Master's degree,11377,4813,6564
2021,Semiconductors,Post-master's certificate,51,24,27
2021,Semiconductors,Postbaccalaureate certificate,371,303,68
2021,Semiconductors,Postsecondary certificate < 60 semester credit hours,691,679,12
2021,Semiconductors,Postsecondary certificate > 60 semester credit hours,14,14,0
2021,Space,All award levels (total),16458,14755,1703
2021,Space,Associate's degree,166,161,5
2021,Space,Bachelor's degree,11437,10786,651
2021,Space,Doctor's degree – research/scholarship,1070,629,441
2021,Space,Master's degree,3531,2948,583
2021,Space,Post-master's certificate,26,21,5
2021,Space,Postbaccalaureate certificate,216,198,18
2021,Space,Postsecondary certificate < 60 semester credit hours,12,12,0
2021,Sustainable Energy Technology,All award levels (total),16988,15879,1109
2021,Sustainable Energy Technology,Associate's degree,823,809,14
2021,Sustainable Energy Technology,Bachelor's degree,12067,11716,351
2021,Sustainable Energy Technology,Doctor's degree – research/scholarship,417,257,160
2021,Sustainable Energy Technology,Master's degree,3273,2705,568
2021,Sustainable Energy Technology,Post-master's certificate,8,4,4
2021,Sustainable Energy Technology,Postbaccalaureate certificate,288,278,10
2021,Sustainable Energy Technology,Postsecondary certificate < 60 semester credit hours,112,110,2
2022,Artificial Intelligence,All award levels (total),90507,70344,20163
2022,Artificial Intelligence,Associate's degree,5836,5507,329
2022,Artificial Intelligence,Bachelor's degree,57161,50616,6545
2022,Artificial Intelligence,Doctor's degree – professional practice,64,64,0
2022,Artificial Intelligence,Doctor's degree – research/scholarship,1657,600,1057
2022,Artificial Intelligence,Master's degree,24144,12278,11866
2022,Artificial Intelligence,Post-master's certificate,42,26,16
2022,Artificial Intelligence,Postbaccalaureate certificate,1106,770,336
2022,Artificial Intelligence,Postsecondary certificate < 60 semester credit hours,335,324,11
2022,Artificial Intelligence,Postsecondary certificate > 60 semester credit hours,162,159,3
2022,Biotechnology and Synthetic Biology,All award levels (total),24784,22504,2280
2022,Biotechnology and Synthetic Biology,Associate's degree,454,433,21
2022,Biotechnology and Synthetic Biology,Bachelor's degree,18698,17663,1035
2022,Biotechnology and Synthetic Biology,Doctor's degree – research/scholarship,1604,1177,427
2022,Biotechnology and Synthetic Biology,Master's degree,3581,2823,758
2022,Biotechnology and Synthetic Biology,Post-master's certificate,46,36,10
2022,Biotechnology and Synthetic Biology,Postbaccalaureate certificate,182,157,25
2022,Biotechnology and Synthetic Biology,Postsecondary certificate < 60 semester credit hours,216,212,4
2022,Biotechnology and Synthetic Biology,Postsecondary certificate > 60 semester credit hours,3,3,0
2022,Cryptography,All award levels (total),137109,110162,26947
2022,Cryptography,Associate's degree,14078,13474,604
2022,Cryptography,Bachelor's degree,82157,71909,10248
2022,Cryptography,Doctor's degree – professional practice,64,64,0
2022,Cryptography,Doctor's degree – research/scholarship,3004,1366,1638
2022,Cryptography,Master's degree,33327,19383,13944
2022,Cryptography,Post-master's certificate,189,113,76
2022,Cryptography,Postbaccalaureate certificate,2340,1943,397
2022,Cryptography,Postsecondary certificate < 60 semester credit hours,1829,1792,37
2022,Cryptography,Postsecondary certificate > 60 semester credit hours,121,118,3
2022,Lasers,All award levels (total),31853,24600,7253
2022,Lasers,Associate's degree,3301,3234,67
2022,Lasers,Bachelor's degree,17837,15768,2069
2022,Lasers,Doctor's degree – research/scholarship,2286,645,1641
2022,Lasers,Master's degree,7127,3694,3433
2022,Lasers,Post-master's certificate,14,7,7
2022,Lasers,Postbaccalaureate certificate,146,121,25
2022,Lasers,Postsecondary certificate < 60 semester credit hours,1105,1094,11
2022,Lasers,Postsecondary certificate > 60 semester credit hours,37,37,0
2022,Materials Science,All award levels (total),19555,15404,4151
2022,Materials Science,Associate's degree,48,44,4
2022,Materials Science,Bachelor's degree,12267,11144,1123
2022,Materials Science,Doctor's degree – research/scholarship,2441,1176,1265
2022,Materials Science,Master's degree,4404,2715,1689
2022,Materials Science,Post-master's certificate,50,26,24
2022,Materials Science,Postbaccalaureate certificate,299,255,44
2022,Materials Science,Postsecondary certificate < 60 semester credit hours,46,44,2
2022,Neuroscience,All award levels (total),15015,14106,909
2022,Neuroscience,Associate's degree,6,6,0
2022,Neuroscience,Bachelor's degree,12679,12170,509
2022,Neuroscience,Doctor's degree – professional practice,3,3,0
2022,Neuroscience,Doctor's degree – research/scholarship,1222,1007,215
2022,Neuroscience,Master's degree,994,820,174
2022,Neuroscience,Post-master's certificate,26,22,4
2022,Neuroscience,Postbaccalaureate certificate,45,38,7
2022,Neuroscience,Postsecondary certificate < 60 semester credit hours,40,40,0
2022,Robotics,All award levels (total),78389,62763,15626
2022,Robotics,Associate's degree,8030,7871,159
2022,Robotics,Bachelor's degree,43754,39500,4254
2022,Robotics,Doctor's degree – research/scholarship,2965,902,2063
2022,Robotics,Master's degree,20072,11112,8960
2022,Robotics,Post-master's certificate,89,78,11
2022,Robotics,Postbaccalaureate certificate,1328,1165,163
2022,Robotics,Postsecondary certificate < 60 semester credit hours,2127,2111,16
2022,Robotics,Postsecondary certificate > 60 semester credit hours,24,24,0
2022,Semiconductors,All award levels (total),45453,35441,10012
2022,Semiconductors,Associate's degree,2658,2587,71
2022,Semiconductors,Bachelor's degree,28064,25097,2967
2022,Semiconductors,Doctor's degree – research/scholarship,3594,1267,2327
2022,Semiconductors,Master's degree,9883,5334,4549
2022,Semiconductors,Post-master's certificate,57,30,27
2022,Semiconductors,Postbaccalaureate certificate,375,316,59
2022,Semiconductors,Postsecondary certificate < 60 semester credit hours,818,806,12
2022,Semiconductors,Postsecondary certificate > 60 semester credit hours,4,4,0
2022,Space,All award levels (total),17195,15567,1628
2022,Space,Associate's degree,196,195,1
2022,Space,Bachelor's degree,11948,11293,655
2022,Space,Doctor's degree – research/scholarship,1187,712,475
2022,Space,Master's degree,3666,3186,480
2022,Space,Post-master's certificate,19,15,4
2022,Space,Postbaccalaureate certificate,167,154,13
2022,Space,Postsecondary certificate < 60 semester credit hours,12,12,0
2022,Sustainable Energy Technology,All award levels (total),17363,16404,959
2022,Sustainable Energy Technology,Associate's degree,854,846,8
2022,Sustainable Energy Technology,Bachelor's degree,12034,11683,351
2022,Sustainable Energy Technology,Doctor's degree – research/scholarship,491,323,168
2022,Sustainable Energy Technology,Master's degree,3542,3151,391
2022,Sustainable Energy Technology,Post-master's certificate,20,12,8
2022,Sustainable Energy Technology,Postbaccalaureate certificate,312,281,31
2022,Sustainable Energy Technology,Postsecondary certificate < 60 semester credit hours,110,108,2
2023,Artificial Intelligence,All award levels (total),107964,73878,34086
2023,Artificial Intelligence,Associate's degree,6076,5821,255
2023,Artificial Intelligence,Bachelor's degree,59037,52736,6301
2023,Artificial Intelligence,Doctor's degree – professional practice,49,49,0
2023,Artificial Intelligence,Doctor's degree – research/scholarship,1701,668,1033
2023,Artificial Intelligence,Master's degree,38986,13053,25933
2023,Artificial Intelligence,Post-master's certificate,67,24,43
2023,Artificial Intelligence,Postbaccalaureate certificate,1358,841,517
2023,Artificial Intelligence,Postsecondary certificate < 60 semester credit hours,469,468,1
2023,Artificial Intelligence,Postsecondary certificate > 60 semester credit hours,221,218,3
2023,Biotechnology and Synthetic Biology,All award levels (total),24824,22161,2663
2023,Biotechnology and Synthetic Biology,Associate's degree,512,485,27
2023,Biotechnology and Synthetic Biology,Bachelor's degree,18206,17233,973
2023,Biotechnology and Synthetic Biology,Doctor's degree – research/scholarship,1698,1218,480
2023,Biotechnology and Synthetic Biology,Master's degree,4004,2861,1143
2023,Biotechnology and Synthetic Biology,Post-master's certificate,32,26,6
2023,Biotechnology and Synthetic Biology,Postbaccalaureate certificate,200,174,26
2023,Biotechnology and Synthetic Biology,Postsecondary certificate < 60 semester credit hours,172,164,8
2023,Cryptography,All award levels (total),155560,115464,40096
2023,Cryptography,Associate's degree,14553,14071,482
2023,Cryptography,Bachelor's degree,84216,74549,9667
2023,Cryptography,Doctor's degree – professional practice,49,49,0
2023,Cryptography,Doctor's degree – research/scholarship,2938,1378,1560
2023,Cryptography,Master's degree,48429,20780,27649
2023,Cryptography,Post-master's certificate,146,72,74
2023,Cryptography,Postbaccalaureate certificate,2720,2085,635
2023,Cryptography,Postsecondary certificate < 60 semester credit hours,2304,2278,26
2023,Cryptography,Postsecondary certificate > 60 semester credit hours,205,202,3
2023,Lasers,All award levels (total),33028,24120,8908
2023,Lasers,Associate's degree,3342,3292,50
2023,Lasers,Bachelor's degree,16953,15155,1798
2023,Lasers,Doctor's degree – other,1,1,0
2023,Lasers,Doctor's degree – research/scholarship,2266,664,1602
2023,Lasers,Master's degree,9185,3790,5395
2023,Lasers,Post-master's certificate,24,8,16
2023,Lasers,Postbaccalaureate certificate,123,82,41
2023,Lasers,Postsecondary certificate < 60 semester credit hours,1080,1074,6
2023,Lasers,Postsecondary certificate > 60 semester credit hours,54,54,0
2023,Materials Science,All award levels (total),19370,14866,4504
2023,Materials Science,Associate's degree,48,42,6
2023,Materials Science,Bachelor's degree,11356,10418,938
2023,Materials Science,Doctor's degree – other,1,1,0
2023,Materials Science,Doctor's degree – research/scholarship,2420,1229,1191
2023,Materials Science,Master's degree,5027,2708,2319
2023,Materials Science,Post-master's certificate,36,22,14
2023,Materials Science,Postbaccalaureate certificate,265,232,33
2023,Materials Science,Postsecondary certificate < 60 semester credit hours,217,214,3
2023,Neuroscience,All award levels (total),15391,14389,1002
2023,Neuroscience,Associate's degree,5,5,0
2023,Neuroscience,Bachelor's degree,12960,12412,548
2023,Neuroscience,Doctor's degree – professional practice,4,4,0
2023,Neuroscience,Doctor's degree – research/scholarship,1235,1034,201
2023,Neuroscience,Master's degree,1063,822,241
2023,Neuroscience,Post-master's certificate,42,38,4
2023,Neuroscience,Postbaccalaureate certificate,55,47,8
2023,Neuroscience,Postsecondary certificate < 60 semester credit hours,26,26,0
2023,Neuroscience,Postsecondary certificate > 60 semester credit hours,1,1,0
2023,Robotics,All award levels (total),84621,63181,21440
2023,Robotics,Associate's degree,8120,7959,161
2023,Robotics,Bachelor's degree,42453,38625,3828
2023,Robotics,Doctor's degree – other,1,1,0
2023,Robotics,Doctor's degree – research/scholarship,2942,993,1949
2023,Robotics,Master's degree,27173,11991,15182
2023,Robotics,Post-master's certificate,80,57,23
2023,Robotics,Postbaccalaureate certificate,1424,1143,281
2023,Robotics,Postsecondary certificate < 60 semester credit hours,2400,2385,15
2023,Robotics,Postsecondary certificate > 60 semester credit hours,28,27,1
2023,Semiconductors,All award levels (total),46323,34527,11796
2023,Semiconductors,Associate's degree,2643,2591,52
2023,Semiconductors,Bachelor's degree,26528,23969,2559
2023,Semiconductors,Doctor's degree – other,2,2,0
2023,Semiconductors,Doctor's degree – research/scholarship,3537,1328,2209
2023,Semiconductors,Master's degree,12281,5406,6875
2023,Semiconductors,Post-master's certificate,52,26,26
2023,Semiconductors,Postbaccalaureate certificate,319,252,67
2023,Semiconductors,Postsecondary certificate < 60 semester credit hours,956,948,8
2023,Semiconductors,Postsecondary certificate > 60 semester credit hours,5,5,0
2023,Space,All award levels (total),17451,15693,1758
2023,Space,Associate's degree,180,177,3
2023,Space,Bachelor's degree,11770,11120,650
2023,Space,Doctor's degree – research/scholarship,1234,787,447
2023,Space,Master's degree,4055,3417,638
2023,Space,Post-master's certificate,33,25,8
2023,Space,Postbaccalaureate certificate,162,150,12
2023,Space,Postsecondary certificate < 60 semester credit hours,17,17,0
2023,Sustainable Energy Technology,All award levels (total),18016,16978,1038
2023,Sustainable Energy Technology,Associate's degree,865,863,2
2023,Sustainable Energy Technology,Bachelor's degree,12377,12100,277
2023,Sustainable Energy Technology,Doctor's degree – research/scholarship,502,312,190
2023,Sustainable Energy Technology,Master's degree,3844,3307,537
2023,Sustainable Energy Technology,Post-master's certificate,21,19,2
2023,Sustainable Energy Technology,Postbaccalaureate certificate,321,292,29
2023,Sustainable Energy Technology,Postsecondary certificate < 60 semester credit hours,81,80,1
2023,Sustainable Energy Technology,Postsecondary certificate > 60 semester credit hours,5,5,0
